datetime,device_cpu_rate%,user%,system%,idle%,package,pid,pid_cpu%
2024-01-18 18-54-15,635,297,338,66,com.yangcong345.android.phone,3883,144
2024-01-18 18-54-20,513,272,241,276,com.yangcong345.android.phone,3883,158
2024-01-18 18-54-25,511,252,259,283,com.yangcong345.android.phone,3883,117
2024-01-18 18-54-30,735,407,328,62,com.yangcong345.android.phone,3883,155
2024-01-18 18-54-35,576,262,314,217,com.yangcong345.android.phone,3883,134
2024-01-18 18-54-41,523,233,290,243,com.yangcong345.android.phone,3883,137
2024-01-18 18-54-45,593,279,314,203,com.yangcong345.android.phone,3883,165
2024-01-18 18-54-50,525,266,259,276,com.yangcong345.android.phone,3883,148
2024-01-18 18-54-55,620,286,334,169,com.yangcong345.android.phone,3883,148
2024-01-18 18-55-00,383,148,235,416,com.yangcong345.android.phone,3883,96.7
2024-01-18 18-55-05,514,243,271,286,com.yangcong345.android.phone,3883,103
2024-01-18 18-55-10,478,221,257,307,com.yangcong345.android.phone,3883,107
2024-01-18 18-55-15,524,248,276,269,com.yangcong345.android.phone,3883,106
2024-01-18 18-55-20,586,300,286,207,com.yangcong345.android.phone,3883,110
2024-01-18 18-55-26,587,319,268,65,com.yangcong345.android.phone,3883,96.7
2024-01-18 18-55-31,570,307,263,63,com.yangcong345.android.phone,3883,76.6
2024-01-18 18-55-35,410,179,231,383,com.yangcong345.android.phone,3883,96.5
2024-01-18 18-55-40,547,236,311,254,com.yangcong345.android.phone,3883,196
2024-01-18 18-55-45,471,207,264,321,com.yangcong345.android.phone,3883,128
2024-01-18 18-55-51,866,483,383,114,com.yangcong345.android.phone,3883,134
2024-01-18 18-55-55,443,200,243,350,com.yangcong345.android.phone,3883,103
2024-01-18 18-56-00,403,196,207,396,com.yangcong345.android.phone,3883,103
2024-01-18 18-56-06,473,266,207,303,com.yangcong345.android.phone,3883,103
2024-01-18 18-56-10,479,207,272,317,com.yangcong345.android.phone,3883,110
2024-01-18 18-56-16,353,170,183,443,com.yangcong345.android.phone,3883,100
2024-01-18 18-56-21,397,207,190,400,com.yangcong345.android.phone,3883,106
2024-01-18 18-56-26,276,153,123,520,com.yangcong345.android.phone,3883,93.3
2024-01-18 18-56-31,400,193,207,393,com.yangcong345.android.phone,3883,103
2024-01-18 18-56-36,432,186,246,361,com.yangcong345.android.phone,3883,92.8
2024-01-18 18-56-41,673,314,359,86,com.yangcong345.android.phone,3883,151
2024-01-18 18-56-46,590,262,328,203,com.yangcong345.android.phone,3883,186
2024-01-18 18-56-51,507,232,275,289,com.yangcong345.android.phone,3883,107
2024-01-18 18-56-56,428,200,228,372,com.yangcong345.android.phone,3883,100
2024-01-18 18-57-01,414,189,225,379,com.yangcong345.android.phone,3883,110
2024-01-18 18-57-06,882,461,421,200,com.yangcong345.android.phone,3883,132
2024-01-18 18-57-11,397,183,214,400,com.yangcong345.android.phone,3883,103
2024-01-18 18-57-16,410,200,210,386,com.yangcong345.android.phone,3883,117
2024-01-18 18-57-21,780,414,366,7,com.yangcong345.android.phone,3883,148
2024-01-18 18-57-26,623,293,330,173,com.yangcong345.android.phone,3883,170
2024-01-18 18-57-31,617,320,297,177,com.yangcong345.android.phone,3883,160
2024-01-18 18-57-36,503,218,285,271,com.yangcong345.android.phone,3883,114
2024-01-18 18-57-41,928,514,414,172,com.yangcong345.android.phone,3883,144
2024-01-18 18-57-46,621,259,362,172,com.yangcong345.android.phone,3883,237
2024-01-18 18-57-51,613,318,295,37,com.yangcong345.android.phone,3883,121
2024-01-18 18-57-56,528,272,256,188,com.yangcong345.android.phone,3883,118
2024-01-18 18-58-01,450,200,250,346,com.yangcong345.android.phone,3883,107
2024-01-18 18-58-06,765,446,319,43,com.yangcong345.android.phone,3883,124
2024-01-18 18-58-11,474,235,239,323,com.yangcong345.android.phone,3883,100
2024-01-18 18-58-16,651,348,303,145,com.yangcong345.android.phone,3883,189
2024-01-18 18-58-21,631,321,310,166,com.yangcong345.android.phone,3883,155
2024-01-18 18-58-26,497,261,236,300,com.yangcong345.android.phone,3883,146
2024-01-18 18-58-31,403,188,215,391,com.yangcong345.android.phone,3883,115
2024-01-18 18-58-36,526,233,293,267,com.yangcong345.android.phone,3883,130
2024-01-18 18-58-41,689,343,346,100,com.yangcong345.android.phone,3883,185
2024-01-18 18-58-46,589,257,332,207,com.yangcong345.android.phone,3883,207
2024-01-18 18-58-51,572,254,318,225,com.yangcong345.android.phone,3883,178
2024-01-18 18-58-56,428,197,231,366,com.yangcong345.android.phone,3883,100
2024-01-18 18-59-01,546,246,300,189,com.yangcong345.android.phone,3883,102
2024-01-18 18-59-06,411,211,200,382,com.yangcong345.android.phone,3883,100
2024-01-18 18-59-11,393,193,200,400,com.yangcong345.android.phone,3883,100
2024-01-18 18-59-16,710,355,355,26,com.yangcong345.android.phone,3883,83.8
2024-01-18 18-59-21,390,190,200,403,com.yangcong345.android.phone,3883,96.5
2024-01-18 18-59-26,655,355,300,138,com.yangcong345.android.phone,3883,186
2024-01-18 18-59-31,462,241,221,334,com.yangcong345.android.phone,3883,141
2024-01-18 18-59-36,492,246,246,300,com.yangcong345.android.phone,3883,132
2024-01-18 18-59-41,733,443,290,33,com.yangcong345.android.phone,3883,150
2024-01-18 18-59-46,449,221,228,348,com.yangcong345.android.phone,3883,131
2024-01-18 18-59-51,552,288,264,242,com.yangcong345.android.phone,3883,136
2024-01-18 18-59-56,769,331,438,21,com.yangcong345.android.phone,3883,200
2024-01-18 19-00-01,454,200,254,339,com.yangcong345.android.phone,3883,117
2024-01-18 19-00-06,593,290,303,200,com.yangcong345.android.phone,3883,162
2024-01-18 19-00-11,577,303,274,216,com.yangcong345.android.phone,3883,161
2024-01-18 19-00-16,668,373,295,81,com.yangcong345.android.phone,3883,110
2024-01-18 19-00-21,793,417,376,72,com.yangcong345.android.phone,3883,172
2024-01-18 19-00-26,687,330,357,0,com.yangcong345.android.phone,3883,86.6
2024-01-18 19-00-31,448,210,238,348,com.yangcong345.android.phone,3883,113
2024-01-18 19-00-36,569,252,317,224,com.yangcong345.android.phone,3883,65.5
2024-01-18 19-00-41,390,190,200,403,com.yangcong345.android.phone,3883,89.6
2024-01-18 19-00-46,472,224,248,324,com.yangcong345.android.phone,3883,148
2024-01-18 19-00-51,589,271,318,207,com.yangcong345.android.phone,3883,217
2024-01-18 19-00-56,518,221,297,276,com.yangcong345.android.phone,3883,86.2
2024-01-18 19-01-01,529,193,336,250,com.yangcong345.android.phone,3883,71.4
2024-01-18 19-01-06,738,352,386,59,com.yangcong345.android.phone,3883,168
2024-01-18 19-01-11,473,221,252,317,com.yangcong345.android.phone,3883,134
2024-01-18 19-01-16,414,207,207,386,com.yangcong345.android.phone,3883,120
2024-01-18 19-01-21,546,225,321,246,com.yangcong345.android.phone,3883,78.5
2024-01-18 19-01-26,525,236,289,271,com.yangcong345.android.phone,3883,67.8
2024-01-18 19-01-31,414,200,214,375,com.yangcong345.android.phone,3883,117
2024-01-18 19-01-36,472,200,272,324,com.yangcong345.android.phone,3883,134
2024-01-18 19-01-41,497,259,238,300,com.yangcong345.android.phone,3883,144
2024-01-18 19-01-46,548,203,345,248,com.yangcong345.android.phone,3883,89.6
2024-01-18 19-01-51,607,257,350,193,com.yangcong345.android.phone,3883,207
2024-01-18 19-01-56,447,222,225,350,com.yangcong345.android.phone,3883,140
2024-01-18 19-02-01,486,224,262,310,com.yangcong345.android.phone,3883,110
2024-01-18 19-02-06,458,229,229,339,com.yangcong345.android.phone,3883,121
2024-01-18 19-02-11,435,207,228,359,com.yangcong345.android.phone,3883,110
2024-01-18 19-02-16,644,372,272,148,com.yangcong345.android.phone,3883,134
2024-01-18 19-02-21,500,218,282,293,com.yangcong345.android.phone,3883,85.7
2024-01-18 19-02-26,586,276,310,207,com.yangcong345.android.phone,3883,100
2024-01-18 19-02-31,451,217,234,338,com.yangcong345.android.phone,3883,144
2024-01-18 19-02-36,827,441,386,155,com.yangcong345.android.phone,3883,124
2024-01-18 19-02-41,724,431,293,72,com.yangcong345.android.phone,3883,151
2024-01-18 19-02-46,800,464,336,46,com.yangcong345.android.phone,3883,160
2024-01-18 19-02-51,527,224,303,272,com.yangcong345.android.phone,3883,100
2024-01-18 19-02-56,638,269,369,155,com.yangcong345.android.phone,3883,206
2024-01-18 19-03-01,503,231,272,290,com.yangcong345.android.phone,3883,96.5
2024-01-18 19-03-06,443,211,232,354,com.yangcong345.android.phone,3883,114
2024-01-18 19-03-11,896,479,417,200,com.yangcong345.android.phone,3883,158
2024-01-18 19-03-16,686,350,336,100,com.yangcong345.android.phone,3883,160
2024-01-18 19-03-21,417,214,203,379,com.yangcong345.android.phone,3883,124
2024-01-18 19-03-26,700,357,343,13,com.yangcong345.android.phone,3883,96.6
2024-01-18 19-03-31,462,234,228,338,com.yangcong345.android.phone,3883,103
2024-01-18 19-03-36,886,483,403,197,com.yangcong345.android.phone,3883,93.1
2024-01-18 19-03-41,473,221,252,321,com.yangcong345.android.phone,3883,103
2024-01-18 19-03-46,452,200,252,345,com.yangcong345.android.phone,3883,100
2024-01-18 19-03-51,455,248,207,345,com.yangcong345.android.phone,3883,165
2024-01-18 19-03-56,638,297,341,155,com.yangcong345.android.phone,3883,268
2024-01-18 19-04-01,662,355,307,107,com.yangcong345.android.phone,3883,210
2024-01-18 19-04-06,545,252,293,255,com.yangcong345.android.phone,3883,134
2024-01-18 19-04-11,511,245,266,283,com.yangcong345.android.phone,3883,151
2024-01-18 19-04-16,525,246,279,271,com.yangcong345.android.phone,3883,100
2024-01-18 19-04-21,518,207,311,279,com.yangcong345.android.phone,3883,89.2
2024-01-18 19-04-26,733,380,353,13,com.yangcong345.android.phone,3883,66.6
2024-01-18 19-04-31,424,224,200,372,com.yangcong345.android.phone,3883,117
2024-01-18 19-04-36,572,269,303,203,com.yangcong345.android.phone,3883,106
2024-01-18 19-04-41,485,189,296,307,com.yangcong345.android.phone,3883,67.8
2024-01-18 19-04-46,436,200,236,361,com.yangcong345.android.phone,3883,114
2024-01-18 19-04-51,397,161,236,400,com.yangcong345.android.phone,3883,50.0
2024-01-18 19-04-56,457,211,246,336,com.yangcong345.android.phone,3883,139
2024-01-18 19-05-01,428,183,245,372,com.yangcong345.android.phone,3883,172
2024-01-18 19-05-06,436,168,268,354,com.yangcong345.android.phone,3883,50.0
2024-01-18 19-05-11,400,182,218,393,com.yangcong345.android.phone,3883,75.0
2024-01-18 19-05-16,665,304,361,107,com.yangcong345.android.phone,3883,82.1
2024-01-18 19-05-21,390,160,230,403,com.yangcong345.android.phone,3883,43.3
2024-01-18 19-05-26,758,348,410,38,com.yangcong345.android.phone,3883,165
2024-01-18 19-05-31,464,221,243,325,com.yangcong345.android.phone,3883,110
2024-01-18 19-05-36,445,224,221,348,com.yangcong345.android.phone,3883,141
2024-01-18 19-05-41,596,262,334,193,com.yangcong345.android.phone,3883,134
2024-01-18 19-05-46,451,217,234,345,com.yangcong345.android.phone,3883,137
2024-01-18 19-05-51,647,336,311,121,com.yangcong345.android.phone,3883,185
2024-01-18 19-05-56,493,252,241,307,com.yangcong345.android.phone,3883,148
2024-01-18 19-06-01,553,214,339,243,com.yangcong345.android.phone,3883,110
2024-01-18 19-06-06,693,293,400,100,com.yangcong345.android.phone,3883,213
2024-01-18 19-06-11,553,214,339,243,com.yangcong345.android.phone,3883,71.4
2024-01-18 19-06-16,542,266,276,255,com.yangcong345.android.phone,3883,148
2024-01-18 19-06-22,300,147,153,500,com.yangcong345.android.phone,3883,83.3
2024-01-18 19-06-26,569,252,317,228,com.yangcong345.android.phone,3883,106
2024-01-18 19-06-31,462,241,221,334,com.yangcong345.android.phone,3883,120
2024-01-18 19-06-36,443,236,207,354,com.yangcong345.android.phone,3883,100
2024-01-18 19-06-41,517,231,286,279,com.yangcong345.android.phone,3883,72.4
2024-01-18 19-06-46,573,290,283,221,com.yangcong345.android.phone,3883,165
2024-01-18 19-06-51,434,200,234,366,com.yangcong345.android.phone,3883,58.6
2024-01-18 19-06-56,563,277,286,131,com.yangcong345.android.phone,3883,128
2024-01-18 19-07-01,468,236,232,325,com.yangcong345.android.phone,3883,210
2024-01-18 19-07-06,713,326,387,97,com.yangcong345.android.phone,3883,93.5
2024-01-18 19-07-11,836,463,373,93,com.yangcong345.android.phone,3883,146
2024-01-18 19-07-16,606,300,306,181,com.yangcong345.android.phone,3883,170
2024-01-18 19-07-21,607,297,310,162,com.yangcong345.android.phone,3883,86.2
2024-01-18 19-07-26,418,200,218,379,com.yangcong345.android.phone,3883,100
2024-01-18 19-07-31,665,355,310,45,com.yangcong345.android.phone,3883,103
2024-01-18 19-07-36,548,255,293,238,com.yangcong345.android.phone,3883,113
2024-01-18 19-07-41,476,243,233,317,com.yangcong345.android.phone,3883,140
2024-01-18 19-07-46,655,331,324,145,com.yangcong345.android.phone,3883,127
2024-01-18 19-07-51,441,200,241,348,com.yangcong345.android.phone,3883,117
2024-01-18 19-07-56,662,362,300,59,com.yangcong345.android.phone,3883,124
2024-01-18 19-08-01,800,369,431,83,com.yangcong345.android.phone,3883,179
2024-01-18 19-08-06,734,367,367,37,com.yangcong345.android.phone,3883,56.6
2024-01-18 19-08-12,345,162,183,455,com.yangcong345.android.phone,3883,82.7
2024-01-18 19-08-16,686,336,350,7,com.yangcong345.android.phone,3883,100
2024-01-18 19-08-21,713,403,310,86,com.yangcong345.android.phone,3883,120
2024-01-18 19-08-26,475,261,214,321,com.yangcong345.android.phone,3883,150
2024-01-18 19-08-31,506,272,234,290,com.yangcong345.android.phone,3883,103
2024-01-18 19-08-36,531,234,297,266,com.yangcong345.android.phone,3883,124
2024-01-18 19-08-41,606,315,291,121,com.yangcong345.android.phone,3883,112
2024-01-18 19-08-46,542,283,259,231,com.yangcong345.android.phone,3883,200
2024-01-18 19-08-52,419,178,241,381,com.yangcong345.android.phone,3883,46.8
2024-01-18 19-08-56,452,190,262,345,com.yangcong345.android.phone,3883,37.9
2024-01-18 19-09-01,493,204,289,304,com.yangcong345.android.phone,3883,192
2024-01-18 19-09-06,411,159,252,386,com.yangcong345.android.phone,3883,24.1
2024-01-18 19-09-11,490,231,259,293,com.yangcong345.android.phone,3883,117
2024-01-18 19-09-16,504,245,259,290,com.yangcong345.android.phone,3883,155
2024-01-18 19-09-21,540,261,279,246,com.yangcong345.android.phone,3883,160
2024-01-18 19-09-26,576,293,283,224,com.yangcong345.android.phone,3883,120
2024-01-18 19-09-32,776,431,345,31,com.yangcong345.android.phone,3883,82.7
2024-01-18 19-09-37,652,345,307,131,com.yangcong345.android.phone,3883,137
2024-01-18 19-09-42,486,203,283,314,com.yangcong345.android.phone,3883,89.6
2024-01-18 19-09-47,421,221,200,375,com.yangcong345.android.phone,3883,100
2024-01-18 19-09-52,420,186,234,376,com.yangcong345.android.phone,3883,82.7
2024-01-18 19-09-57,432,189,243,364,com.yangcong345.android.phone,3883,135
2024-01-18 19-10-02,849,397,452,62,com.yangcong345.android.phone,3883,217
2024-01-18 19-10-07,877,470,407,253,com.yangcong345.android.phone,3883,80.0
2024-01-18 19-10-12,748,400,348,7,com.yangcong345.android.phone,3883,127
2024-01-18 19-10-17,683,338,345,114,com.yangcong345.android.phone,3883,151
2024-01-18 19-10-22,545,300,245,252,com.yangcong345.android.phone,3883,134
2024-01-18 19-10-27,640,357,283,110,com.yangcong345.android.phone,3883,156
2024-01-18 19-10-32,428,221,207,369,com.yangcong345.android.phone,3883,134
2024-01-18 19-10-38,338,214,124,400,com.yangcong345.android.phone,3883,96.5
2024-01-18 19-10-42,489,193,296,304,com.yangcong345.android.phone,3883,67.8
2024-01-18 19-10-48,342,221,121,454,com.yangcong345.android.phone,3883,164
2024-01-18 19-10-52,530,287,243,263,com.yangcong345.android.phone,3883,163
2024-01-18 19-10-57,781,384,397,122,com.yangcong345.android.phone,3883,193
2024-01-18 19-11-02,759,376,383,14,com.yangcong345.android.phone,3883,137
2024-01-18 19-11-07,611,311,300,186,com.yangcong345.android.phone,3883,167
2024-01-18 19-11-12,494,257,237,300,com.yangcong345.android.phone,3883,123
2024-01-18 19-11-17,452,224,228,341,com.yangcong345.android.phone,3883,124
2024-01-18 19-11-22,500,255,245,300,com.yangcong345.android.phone,3883,141
2024-01-18 19-11-27,717,423,294,55,com.yangcong345.android.phone,3883,96.7
2024-01-18 19-11-32,414,200,214,382,com.yangcong345.android.phone,3883,103
2024-01-18 19-11-37,479,245,234,310,com.yangcong345.android.phone,3883,100
2024-01-18 19-11-42,403,183,220,390,com.yangcong345.android.phone,3883,80.0
2024-01-18 19-11-47,560,239,321,236,com.yangcong345.android.phone,3883,107
2024-01-18 19-11-52,536,225,311,261,com.yangcong345.android.phone,3883,85.7
2024-01-18 19-11-57,628,307,321,171,com.yangcong345.android.phone,3883,135
2024-01-18 19-12-02,607,261,346,189,com.yangcong345.android.phone,3883,207
2024-01-18 19-12-07,555,262,293,221,com.yangcong345.android.phone,3883,110
2024-01-18 19-12-12,468,229,239,323,com.yangcong345.android.phone,3883,125
2024-01-18 19-12-17,593,250,343,190,com.yangcong345.android.phone,3883,53.3
2024-01-18 19-12-22,517,193,324,279,com.yangcong345.android.phone,3883,34.4
2024-01-18 19-12-27,439,214,225,357,com.yangcong345.android.phone,3883,100
2024-01-18 19-12-32,520,230,290,260,com.yangcong345.android.phone,3883,90.0
2024-01-18 19-12-37,938,552,386,234,com.yangcong345.android.phone,3883,196
2024-01-18 19-12-42,524,248,276,266,com.yangcong345.android.phone,3883,151
2024-01-18 19-12-47,670,317,353,127,com.yangcong345.android.phone,3883,86.6
2024-01-18 19-12-52,466,238,228,328,com.yangcong345.android.phone,3883,144
2024-01-18 19-12-57,629,275,354,164,com.yangcong345.android.phone,3883,96.4
2024-01-18 19-13-02,669,324,345,34,com.yangcong345.android.phone,3883,82.7
2024-01-18 19-13-07,572,268,304,225,com.yangcong345.android.phone,3883,210
2024-01-18 19-13-12,350,157,193,446,com.yangcong345.android.phone,3883,92.8
2024-01-18 19-13-17,417,186,231,379,com.yangcong345.android.phone,3883,110
2024-01-18 19-13-22,425,175,250,371,com.yangcong345.android.phone,3883,42.8
2024-01-18 19-13-27,345,161,184,452,com.yangcong345.android.phone,3883,90.3
2024-01-18 19-13-32,614,317,297,179,com.yangcong345.android.phone,3883,144
2024-01-18 19-13-37,839,418,421,191,com.yangcong345.android.phone,3883,121
2024-01-18 19-13-42,498,224,274,279,com.yangcong345.android.phone,3883,155
2024-01-18 19-13-47,467,200,267,330,com.yangcong345.android.phone,3883,66.6
2024-01-18 19-13-52,531,255,276,262,com.yangcong345.android.phone,3883,148
2024-01-18 19-13-57,561,243,318,236,com.yangcong345.android.phone,3883,67.8
2024-01-18 19-14-02,597,269,328,166,com.yangcong345.android.phone,3883,124
2024-01-18 19-14-07,493,248,245,281,com.yangcong345.android.phone,3883,203
2024-01-18 19-14-12,510,248,262,286,com.yangcong345.android.phone,3883,182
2024-01-18 19-14-17,714,428,286,14,com.yangcong345.android.phone,3883,103
2024-01-18 19-14-22,529,238,291,259,com.yangcong345.android.phone,3883,118
2024-01-18 19-14-27,558,255,303,234,com.yangcong345.android.phone,3883,96.5
2024-01-18 19-14-32,707,390,317,7,com.yangcong345.android.phone,3883,196
2024-01-18 19-14-37,487,247,240,290,com.yangcong345.android.phone,3883,150
2024-01-18 19-14-42,513,234,279,283,com.yangcong345.android.phone,3883,113
2024-01-18 19-14-47,707,350,357,7,com.yangcong345.android.phone,3883,132
2024-01-18 19-14-52,665,393,272,69,com.yangcong345.android.phone,3883,113
2024-01-18 19-14-57,383,179,204,414,com.yangcong345.android.phone,3883,60.7
2024-01-18 19-15-02,624,314,310,134,com.yangcong345.android.phone,3883,151
2024-01-18 19-15-07,424,186,238,372,com.yangcong345.android.phone,3883,41.3
2024-01-18 19-15-12,820,427,393,123,com.yangcong345.android.phone,3883,140
2024-01-18 19-15-17,440,233,207,357,com.yangcong345.android.phone,3883,100
2024-01-18 19-15-22,407,168,239,389,com.yangcong345.android.phone,3883,39.2
2024-01-18 19-15-27,397,186,211,400,com.yangcong345.android.phone,3883,100
2024-01-18 19-15-32,497,268,229,300,com.yangcong345.android.phone,3883,110
2024-01-18 19-15-37,431,214,217,366,com.yangcong345.android.phone,3883,124
2024-01-18 19-15-42,361,170,191,433,com.yangcong345.android.phone,3883,87.8
2024-01-18 19-15-47,361,161,200,436,com.yangcong345.android.phone,3883,100
2024-01-18 19-15-52,557,297,260,237,com.yangcong345.android.phone,3883,143
2024-01-18 19-15-57,427,217,210,366,com.yangcong345.android.phone,3883,120
2024-01-18 19-16-02,676,390,286,117,com.yangcong345.android.phone,3883,131
2024-01-18 19-16-07,576,248,328,221,com.yangcong345.android.phone,3883,48.2
2024-01-18 19-16-12,506,234,272,290,com.yangcong345.android.phone,3883,113
2024-01-18 19-16-17,600,243,357,193,com.yangcong345.android.phone,3883,156
2024-01-18 19-16-22,713,348,365,48,com.yangcong345.android.phone,3883,174
2024-01-18 19-16-27,817,410,407,59,com.yangcong345.android.phone,3883,213
2024-01-18 19-16-32,434,217,217,362,com.yangcong345.android.phone,3883,131
2024-01-18 19-16-38,694,365,329,74,com.yangcong345.android.phone,3883,105
2024-01-18 19-16-42,418,197,221,383,com.yangcong345.android.phone,3883,103
2024-01-18 19-16-47,496,248,248,300,com.yangcong345.android.phone,3883,155
2024-01-18 19-16-52,476,252,224,324,com.yangcong345.android.phone,3883,137
2024-01-18 19-16-57,555,238,317,241,com.yangcong345.android.phone,3883,79.3
2024-01-18 19-17-02,479,231,248,321,com.yangcong345.android.phone,3883,148
2024-01-18 19-17-08,600,314,286,89,com.yangcong345.android.phone,3883,151
2024-01-18 19-17-12,503,214,289,293,com.yangcong345.android.phone,3883,78.5
2024-01-18 19-17-17,600,272,328,186,com.yangcong345.android.phone,3883,272
2024-01-18 19-17-23,563,269,294,84,com.yangcong345.android.phone,3883,121
2024-01-18 19-17-27,439,214,225,350,com.yangcong345.android.phone,3883,125
2024-01-18 19-17-32,407,186,221,389,com.yangcong345.android.phone,3883,103
2024-01-18 19-17-37,537,257,280,260,com.yangcong345.android.phone,3883,193
2024-01-18 19-17-43,560,260,300,143,com.yangcong345.android.phone,3883,113
2024-01-18 19-17-48,743,390,353,40,com.yangcong345.android.phone,3883,130
2024-01-18 19-17-53,703,386,317,72,com.yangcong345.android.phone,3883,262
2024-01-18 19-17-58,559,245,314,234,com.yangcong345.android.phone,3883,158
2024-01-18 19-18-03,578,281,297,113,com.yangcong345.android.phone,3883,158
2024-01-18 19-18-08,469,210,259,324,com.yangcong345.android.phone,3883,58.6
2024-01-18 19-18-13,593,283,310,193,com.yangcong345.android.phone,3883,117
2024-01-18 19-18-18,482,232,250,318,com.yangcong345.android.phone,3883,202
2024-01-18 19-18-23,410,164,246,386,com.yangcong345.android.phone,3883,28.5
2024-01-18 19-18-28,379,176,203,417,com.yangcong345.android.phone,3883,100
2024-01-18 19-18-33,545,300,245,248,com.yangcong345.android.phone,3883,165
2024-01-18 19-18-38,569,286,283,224,com.yangcong345.android.phone,3883,127
2024-01-18 19-18-43,528,269,259,272,com.yangcong345.android.phone,3883,168
2024-01-18 19-18-48,552,276,276,245,com.yangcong345.android.phone,3883,151
2024-01-18 19-18-53,656,359,297,7,com.yangcong345.android.phone,3883,200
2024-01-18 19-18-58,271,119,152,442,com.yangcong345.android.phone,3883,167
2024-01-18 19-19-03,476,279,197,324,com.yangcong345.android.phone,3883,120
2024-01-18 19-19-08,472,234,238,328,com.yangcong345.android.phone,3883,151
2024-01-18 19-19-14,544,269,275,122,com.yangcong345.android.phone,3883,50.0
2024-01-18 19-19-18,530,217,313,270,com.yangcong345.android.phone,3883,150
2024-01-18 19-19-23,397,214,183,400,com.yangcong345.android.phone,3883,131
2024-01-18 19-19-28,508,254,254,293,com.yangcong345.android.phone,3883,78.5
2024-01-18 19-19-33,343,143,200,450,com.yangcong345.android.phone,3883,35.7
2024-01-18 19-19-38,319,113,206,481,com.yangcong345.android.phone,3883,25.0
2024-01-18 19-19-43,593,293,300,200,com.yangcong345.android.phone,3883,117
2024-01-18 19-19-48,535,276,259,255,com.yangcong345.android.phone,3883,124
2024-01-18 19-19-53,355,131,224,407,com.yangcong345.android.phone,3883,34.4
2024-01-18 19-19-58,459,245,214,334,com.yangcong345.android.phone,3883,106
2024-01-18 19-20-03,321,157,164,479,com.yangcong345.android.phone,3883,50.0
2024-01-18 19-20-08,566,307,259,224,com.yangcong345.android.phone,3883,124
2024-01-18 19-20-13,279,104,175,521,com.yangcong345.android.phone,3883,50.0
2024-01-18 19-20-18,584,284,300,161,com.yangcong345.android.phone,3883,135
2024-01-18 19-20-23,607,259,348,190,com.yangcong345.android.phone,3883,103
2024-01-18 19-20-28,316,153,163,477,com.yangcong345.android.phone,3883,136
2024-01-18 19-20-33,317,169,148,472,com.yangcong345.android.phone,3883,103
2024-01-18 19-20-38,372,193,179,403,com.yangcong345.android.phone,3883,106
2024-01-18 19-20-43,325,157,168,471,com.yangcong345.android.phone,3883,100
2024-01-18 19-20-48,336,150,186,461,com.yangcong345.android.phone,3883,85.7
2024-01-18 19-20-53,425,200,225,368,com.yangcong345.android.phone,3883,57.1
2024-01-18 19-20-58,273,107,166,524,com.yangcong345.android.phone,3883,37.9
2024-01-18 19-21-03,314,169,145,483,com.yangcong345.android.phone,3883,106
2024-01-18 19-21-08,550,321,229,243,com.yangcong345.android.phone,3883,167
2024-01-18 19-21-13,827,479,348,190,com.yangcong345.android.phone,3883,141
2024-01-18 19-21-18,466,266,200,328,com.yangcong345.android.phone,3883,155
2024-01-18 19-21-23,375,193,182,418,com.yangcong345.android.phone,3883,107
2024-01-18 19-21-28,672,268,404,129,com.yangcong345.android.phone,3883,192
2024-01-18 19-21-33,545,286,259,186,com.yangcong345.android.phone,3883,127
2024-01-18 19-21-38,531,293,238,234,com.yangcong345.android.phone,3883,96.5
2024-01-18 19-21-43,366,145,221,428,com.yangcong345.android.phone,3883,17.2
2024-01-18 19-21-48,375,150,225,421,com.yangcong345.android.phone,3883,46.4
2024-01-18 19-21-53,375,204,171,418,com.yangcong345.android.phone,3883,96.4
2024-01-18 19-21-58,717,400,317,79,com.yangcong345.android.phone,3883,62.0
2024-01-18 19-22-03,297,129,168,504,com.yangcong345.android.phone,3883,60.7
2024-01-18 19-22-08,576,328,248,138,com.yangcong345.android.phone,3883,220
2024-01-18 19-22-13,456,228,228,345,com.yangcong345.android.phone,3883,137
2024-01-18 19-22-18,607,280,327,77,com.yangcong345.android.phone,3883,176
2024-01-18 19-22-23,439,200,239,357,com.yangcong345.android.phone,3883,132
2024-01-18 19-22-28,531,245,286,228,com.yangcong345.android.phone,3883,103
2024-01-18 19-22-33,462,200,262,331,com.yangcong345.android.phone,3883,217
2024-01-18 19-22-38,462,210,252,331,com.yangcong345.android.phone,3883,86.2
2024-01-18 19-22-43,342,121,221,432,com.yangcong345.android.phone,3883,14.2
2024-01-18 19-22-48,458,229,229,343,com.yangcong345.android.phone,3883,100
2024-01-18 19-22-53,450,277,173,350,com.yangcong345.android.phone,3883,103
2024-01-18 19-22-58,593,283,310,110,com.yangcong345.android.phone,3883,82.7
2024-01-18 19-23-04,285,97,188,509,com.yangcong345.android.phone,3883,9.3
2024-01-18 19-23-08,638,376,262,38,com.yangcong345.android.phone,3883,93.1
2024-01-18 19-23-13,353,164,189,421,com.yangcong345.android.phone,3883,92.8
2024-01-18 19-23-18,656,390,266,138,com.yangcong345.android.phone,3883,196
2024-01-18 19-23-23,793,429,364,39,com.yangcong345.android.phone,3883,214
2024-01-18 19-23-28,365,179,186,436,com.yangcong345.android.phone,3883,103
2024-01-18 19-23-34,666,369,297,16,com.yangcong345.android.phone,3883,184
2024-01-18 19-23-38,531,276,255,266,com.yangcong345.android.phone,3883,82.7
2024-01-18 19-23-43,379,175,204,411,com.yangcong345.android.phone,3883,100
2024-01-18 19-23-49,372,178,194,428,com.yangcong345.android.phone,3883,103
2024-01-18 19-23-53,400,210,190,383,com.yangcong345.android.phone,3883,113
2024-01-18 19-23-58,493,269,224,279,com.yangcong345.android.phone,3883,124
2024-01-18 19-24-03,333,130,203,463,com.yangcong345.android.phone,3883,3.3
2024-01-18 19-24-08,366,159,207,434,com.yangcong345.android.phone,3883,20.6
2024-01-18 19-24-13,382,203,179,414,com.yangcong345.android.phone,3883,48.2
2024-01-18 19-24-18,662,331,331,34,com.yangcong345.android.phone,3883,137
2024-01-18 19-24-23,400,193,207,396,com.yangcong345.android.phone,3883,146
2024-01-18 19-24-28,517,267,250,277,com.yangcong345.android.phone,3883,183
2024-01-18 19-24-33,262,152,110,534,com.yangcong345.android.phone,3883,110
2024-01-18 19-24-38,531,341,190,238,com.yangcong345.android.phone,3883,144
2024-01-18 19-24-43,397,197,200,400,com.yangcong345.android.phone,3883,110
2024-01-18 19-24-49,375,194,181,419,com.yangcong345.android.phone,3883,119
2024-01-18 19-24-53,343,182,161,446,com.yangcong345.android.phone,3883,114
2024-01-18 19-24-58,350,189,161,446,com.yangcong345.android.phone,3883,96.4
2024-01-18 19-25-04,604,275,329,164,com.yangcong345.android.phone,3883,135
2024-01-18 19-25-09,634,262,372,117,com.yangcong345.android.phone,3883,120
2024-01-18 19-25-14,597,369,228,103,com.yangcong345.android.phone,3883,134
2024-01-18 19-25-19,496,241,255,300,com.yangcong345.android.phone,3883,110
2024-01-18 19-25-24,624,300,324,103,com.yangcong345.android.phone,3883,96.5
2024-01-18 19-25-28,371,150,221,429,com.yangcong345.android.phone,3883,60.7
2024-01-18 19-25-34,700,390,310,43,com.yangcong345.android.phone,3883,233
2024-01-18 19-25-39,393,210,183,407,com.yangcong345.android.phone,3883,106
2024-01-18 19-25-44,645,331,314,138,com.yangcong345.android.phone,3883,100
2024-01-18 19-25-49,367,146,221,432,com.yangcong345.android.phone,3883,46.4
2024-01-18 19-25-54,339,189,150,446,com.yangcong345.android.phone,3883,110
2024-01-18 19-25-59,353,160,193,433,com.yangcong345.android.phone,3883,83.3
2024-01-18 19-26-04,462,217,245,331,com.yangcong345.android.phone,3883,89.6
2024-01-18 19-26-09,496,221,275,300,com.yangcong345.android.phone,3883,78.5
2024-01-18 19-26-14,438,214,224,355,com.yangcong345.android.phone,3883,100
2024-01-18 19-26-19,427,234,193,324,com.yangcong345.android.phone,3883,110
2024-01-18 19-26-25,162,48,114,617,com.yangcong345.android.phone,3883,3.4
2024-01-18 19-26-29,676,345,331,34,com.yangcong345.android.phone,3883,172
2024-01-18 19-26-34,752,287,465,94,com.yangcong345.android.phone,3883,170
2024-01-18 19-26-39,655,314,341,3,com.yangcong345.android.phone,3883,106
2024-01-18 19-26-51,227,18,209,141,com.yangcong345.android.phone,3883,8.8
2024-01-18 19-26-52,166,24,142,221,com.yangcong345.android.phone,3883,3.0
2024-01-18 19-26-57,448,103,345,34,com.yangcong345.android.phone,3883,10.3
2024-01-18 19-27-02,451,103,348,28,com.yangcong345.android.phone,3883,86.2
2024-01-18 19-27-07,684,387,297,83,com.yangcong345.android.phone,9443,123
2024-01-18 19-27-12,734,362,372,17,com.yangcong345.android.phone,9443,134
2024-01-18 19-27-17,880,493,387,83,com.yangcong345.android.phone,9443,263
2024-01-18 19-27-22,725,381,344,25,com.yangcong345.android.phone,9443,146
2024-01-18 19-27-27,686,310,376,100,com.yangcong345.android.phone,9443,34.4
2024-01-18 19-27-32,188,23,165,110,com.yangcong345.android.phone,9443,16.1
2024-01-18 19-27-37,235,32,203,274,com.yangcong345.android.phone,9443,12.9
2024-01-18 19-27-42,250,29,221,139,com.yangcong345.android.phone,9443,21.4
2024-01-18 19-27-47,184,19,165,235,com.yangcong345.android.phone,9443,12.9
2024-01-18 19-27-54,180,30,150,277,com.yangcong345.android.phone,9443,3.3
2024-01-18 19-27-58,152,13,139,306,com.yangcong345.android.phone,9443,3.2
2024-01-18 19-28-02,253,23,230,147,com.yangcong345.android.phone,9443,3.3
2024-01-18 19-28-07,318,164,154,443,com.yangcong345.android.phone,12076,0.0
2024-01-18 19-28-12,677,430,247,90,com.yangcong345.android.phone,12121,336
2024-01-18 19-28-17,845,519,326,110,com.yangcong345.android.phone,12121,316
2024-01-18 19-28-22,659,369,290,131,com.yangcong345.android.phone,12121,117
2024-01-18 19-28-27,445,193,252,352,com.yangcong345.android.phone,12121,65.5
2024-01-18 19-28-32,572,238,334,224,com.yangcong345.android.phone,12121,75.8
2024-01-18 19-28-37,396,182,214,400,com.yangcong345.android.phone,12121,53.5
2024-01-18 19-28-42,500,200,300,300,com.yangcong345.android.phone,12121,53.5
2024-01-18 19-28-47,506,197,309,294,com.yangcong345.android.phone,12121,106
2024-01-18 19-28-52,479,207,272,314,com.yangcong345.android.phone,12121,86.2
2024-01-18 19-28-57,410,164,246,382,com.yangcong345.android.phone,15848,0.0
2024-01-18 19-29-02,289,114,175,511,com.yangcong345.android.phone,16210,0.0
2024-01-18 19-29-07,497,229,268,296,com.yangcong345.android.phone,16478,0.0
2024-01-18 19-29-12,329,118,211,468,com.yangcong345.android.phone,12121,14.2
2024-01-18 19-29-17,357,139,218,443,com.yangcong345.android.phone,17153,0.0
2024-01-18 19-29-22,239,100,139,561,com.yangcong345.android.phone,12121,3.5
2024-01-18 19-29-27,328,139,189,468,com.yangcong345.android.phone,17734,0.0
2024-01-18 19-29-32,364,132,232,432,com.yangcong345.android.phone,12121,14.2
2024-01-18 19-29-37,403,206,197,384,com.yangcong345.android.phone,12121,31.2
2024-01-18 19-29-42,393,179,214,400,com.yangcong345.android.phone,12121,17.8
2024-01-18 19-29-47,342,121,221,454,com.yangcong345.android.phone,12121,14.2
2024-01-18 19-29-52,322,129,193,475,com.yangcong345.android.phone,19239,0.0
2024-01-18 19-29-57,347,136,211,450,com.yangcong345.android.phone,19620,0.0
2024-01-18 19-30-02,278,110,168,516,com.yangcong345.android.phone,19890,0.0
2024-01-18 19-30-07,347,143,204,450,com.yangcong345.android.phone,20392,0.0
2024-01-18 19-30-12,322,122,200,478,com.yangcong345.android.phone,20544,0.0
2024-01-18 19-30-17,454,175,279,339,com.yangcong345.android.phone,12121,53.5
2024-01-18 19-30-22,325,121,204,475,com.yangcong345.android.phone,12121,39.2
2024-01-18 19-30-27,328,138,190,472,com.yangcong345.android.phone,21615,0.0
2024-01-18 19-30-32,382,150,232,414,com.yangcong345.android.phone,21936,0.0
2024-01-18 19-30-37,322,116,206,477,com.yangcong345.android.phone,12121,19.3
2024-01-18 19-30-42,375,141,234,421,com.yangcong345.android.phone,12121,6.8
2024-01-18 19-30-47,321,121,200,475,com.yangcong345.android.phone,12121,3.5
2024-01-18 19-30-52,304,114,190,497,com.yangcong345.android.phone,12121,17.2
2024-01-18 19-30-57,341,103,238,459,com.yangcong345.android.phone,23417,0.0
2024-01-18 19-31-02,323,123,200,474,com.yangcong345.android.phone,23732,0.0
2024-01-18 19-31-07,396,164,232,400,com.yangcong345.android.phone,12121,14.2
2024-01-18 19-31-12,340,111,229,454,com.yangcong345.android.phone,12121,3.5
2024-01-18 19-31-17,435,194,241,356,com.yangcong345.android.phone,12121,31.2
2024-01-18 19-31-22,310,113,197,487,com.yangcong345.android.phone,12121,3.2
2024-01-18 19-31-27,315,111,204,486,com.yangcong345.android.phone,25259,0.0
2024-01-18 19-31-32,335,121,214,461,com.yangcong345.android.phone,25512,0.0
2024-01-18 19-31-37,427,193,234,372,com.yangcong345.android.phone,12121,68.9
2024-01-18 19-31-42,467,196,271,329,com.yangcong345.android.phone,12121,67.8
2024-01-18 19-31-47,486,218,268,311,com.yangcong345.android.phone,12121,96.4
2024-01-18 19-31-52,532,218,314,264,com.yangcong345.android.phone,12121,153
2024-01-18 19-31-57,490,224,266,297,com.yangcong345.android.phone,12121,100
2024-01-18 19-32-02,604,327,277,187,com.yangcong345.android.phone,12121,136
2024-01-18 19-32-07,458,186,272,331,com.yangcong345.android.phone,12121,68.9
2024-01-18 19-32-12,532,288,244,269,com.yangcong345.android.phone,12121,112
2024-01-18 19-32-17,461,186,275,336,com.yangcong345.android.phone,12121,42.8
2024-01-18 19-32-22,455,193,262,341,com.yangcong345.android.phone,12121,65.5
2024-01-18 19-32-27,783,469,314,76,com.yangcong345.android.phone,12121,400
2024-01-18 19-32-32,379,179,200,421,com.yangcong345.android.phone,12121,50.0
2024-01-18 19-32-37,371,165,206,423,com.yangcong345.android.phone,12121,41.9
2024-01-18 19-32-42,460,219,241,334,com.yangcong345.android.phone,12121,84.3
2024-01-18 19-32-47,491,244,247,306,com.yangcong345.android.phone,12121,81.2
2024-01-18 19-32-52,457,257,200,343,com.yangcong345.android.phone,12121,71.4
2024-01-18 19-32-57,564,271,293,225,com.yangcong345.android.phone,12121,60.7
2024-01-18 19-33-02,457,193,264,343,com.yangcong345.android.phone,12121,46.4
2024-01-18 19-33-07,461,200,261,332,com.yangcong345.android.phone,12121,32.1
2024-01-18 19-33-12,650,311,339,146,com.yangcong345.android.phone,12121,185
2024-01-18 19-33-17,525,250,275,268,com.yangcong345.android.phone,12121,60.7
2024-01-18 19-33-22,536,229,307,236,com.yangcong345.android.phone,12121,50.0
2024-01-18 19-33-27,383,159,224,410,com.yangcong345.android.phone,12121,44.8
2024-01-18 19-33-32,419,184,235,374,com.yangcong345.android.phone,12121,45.1
2024-01-18 19-33-37,494,213,281,300,com.yangcong345.android.phone,12121,68.7
2024-01-18 19-33-42,418,175,243,379,com.yangcong345.android.phone,12121,53.5
2024-01-18 19-33-47,429,177,252,365,com.yangcong345.android.phone,12121,41.9
2024-01-18 19-33-52,410,171,239,382,com.yangcong345.android.phone,12121,46.4
2024-01-18 19-33-57,425,168,257,364,com.yangcong345.android.phone,12121,78.5
2024-01-18 19-34-02,460,189,271,339,com.yangcong345.android.phone,12121,67.8
2024-01-18 19-34-07,432,189,243,361,com.yangcong345.android.phone,12121,50.0
2024-01-18 19-34-12,424,190,234,372,com.yangcong345.android.phone,12121,62.0
2024-01-18 19-34-17,538,303,235,250,com.yangcong345.android.phone,12121,129
2024-01-18 19-34-22,772,462,310,41,com.yangcong345.android.phone,12121,168
2024-01-18 19-34-27,752,424,328,72,com.yangcong345.android.phone,12121,179
2024-01-18 19-34-32,420,179,241,379,com.yangcong345.android.phone,12121,62.0
2024-01-18 19-34-37,577,297,280,167,com.yangcong345.android.phone,12121,76.6
2024-01-18 19-34-42,418,168,250,382,com.yangcong345.android.phone,12121,57.1
2024-01-18 19-34-47,415,179,236,386,com.yangcong345.android.phone,12121,39.2
2024-01-18 19-34-52,400,150,250,396,com.yangcong345.android.phone,12121,42.8
2024-01-18 19-34-57,450,196,254,343,com.yangcong345.android.phone,12121,42.8
2024-01-18 19-35-02,425,194,231,366,com.yangcong345.android.phone,12121,46.8
2024-01-18 19-35-07,513,200,313,284,com.yangcong345.android.phone,12121,45.1
2024-01-18 19-35-12,527,247,280,267,com.yangcong345.android.phone,12121,53.3
2024-01-18 19-35-17,458,179,279,339,com.yangcong345.android.phone,12121,46.4
2024-01-18 19-35-22,727,390,337,107,com.yangcong345.android.phone,12121,90.0
2024-01-18 19-35-27,446,200,246,350,com.yangcong345.android.phone,12121,50.0
2024-01-18 19-35-32,348,155,193,448,com.yangcong345.android.phone,12121,58.6
2024-01-18 19-35-37,525,193,332,271,com.yangcong345.android.phone,12121,117
2024-01-18 19-35-42,658,284,374,139,com.yangcong345.android.phone,12121,138
2024-01-18 19-35-47,476,179,297,324,com.yangcong345.android.phone,12121,37.9
2024-01-18 19-35-52,614,289,325,175,com.yangcong345.android.phone,12121,103
2024-01-18 19-35-57,379,143,236,418,com.yangcong345.android.phone,12121,25.0
2024-01-18 19-36-02,425,200,225,375,com.yangcong345.android.phone,12121,39.2
2024-01-18 19-36-07,475,228,247,319,com.yangcong345.android.phone,12121,56.2
2024-01-18 19-36-12,453,164,289,336,com.yangcong345.android.phone,12121,39.2
2024-01-18 19-36-17,325,164,161,471,com.yangcong345.android.phone,12121,28.5
2024-01-18 19-36-22,439,196,243,357,com.yangcong345.android.phone,12121,42.8
2024-01-18 19-36-27,587,297,290,210,com.yangcong345.android.phone,12121,86.2
2024-01-18 19-36-32,421,182,239,379,com.yangcong345.android.phone,12121,32.1
2024-01-18 19-36-37,457,186,271,336,com.yangcong345.android.phone,12121,42.8
2024-01-18 19-36-42,429,193,236,368,com.yangcong345.android.phone,12121,50.0
2024-01-18 19-36-47,500,214,286,275,com.yangcong345.android.phone,12121,60.7
2024-01-18 19-36-52,486,200,286,311,com.yangcong345.android.phone,12121,121
2024-01-18 19-36-57,425,171,254,368,com.yangcong345.android.phone,12121,67.8
2024-01-18 19-37-02,431,176,255,366,com.yangcong345.android.phone,12121,41.3
2024-01-18 19-37-07,481,175,306,313,com.yangcong345.android.phone,12121,40.6
2024-01-18 19-37-12,318,154,164,471,com.yangcong345.android.phone,12121,3.5
2024-01-18 19-37-17,400,154,246,396,com.yangcong345.android.phone,12121,50.0
2024-01-18 19-37-22,360,141,219,438,com.yangcong345.android.phone,12121,6.2
2024-01-18 19-37-27,368,168,200,429,com.yangcong345.android.phone,12121,42.8
2024-01-18 19-37-32,447,219,228,353,com.yangcong345.android.phone,12121,34.3
2024-01-18 19-37-37,393,179,214,396,com.yangcong345.android.phone,12121,3.5
2024-01-18 19-37-42,449,191,258,345,com.yangcong345.android.phone,12121,45.4
2024-01-18 19-37-47,389,171,218,407,com.yangcong345.android.phone,12121,32.1
2024-01-18 19-37-52,454,193,261,343,com.yangcong345.android.phone,12121,42.8
2024-01-18 19-37-57,382,136,246,411,com.yangcong345.android.phone,12121,7.1
2024-01-18 19-38-02,566,225,341,228,com.yangcong345.android.phone,12121,159
2024-01-18 19-38-07,586,257,329,200,com.yangcong345.android.phone,12121,71.4
2024-01-18 19-38-12,370,143,227,427,com.yangcong345.android.phone,12121,40.0
2024-01-18 19-38-17,534,284,250,256,com.yangcong345.android.phone,12121,65.6
2024-01-18 19-38-22,539,225,314,257,com.yangcong345.android.phone,12121,67.8
2024-01-18 19-38-27,487,228,259,307,com.yangcong345.android.phone,12121,31.0
2024-01-18 19-38-32,410,146,264,386,com.yangcong345.android.phone,12121,39.2
2024-01-18 19-38-37,450,182,268,346,com.yangcong345.android.phone,12121,42.8
2024-01-18 19-38-42,368,159,209,428,com.yangcong345.android.phone,12121,3.1
2024-01-18 19-38-47,393,168,225,404,com.yangcong345.android.phone,12121,42.8
2024-01-18 19-38-52,404,193,211,393,com.yangcong345.android.phone,12121,46.4
2024-01-18 19-38-57,435,171,264,361,com.yangcong345.android.phone,12121,35.7
2024-01-18 19-39-02,447,211,236,350,com.yangcong345.android.phone,12121,42.8
2024-01-18 19-39-07,443,159,284,353,com.yangcong345.android.phone,12121,9.3
2024-01-18 19-39-12,400,153,247,359,com.yangcong345.android.phone,12121,85.2
2024-01-18 19-39-17,475,171,304,318,com.yangcong345.android.phone,12121,67.8
2024-01-18 19-39-22,625,279,346,168,com.yangcong345.android.phone,12121,71.4
2024-01-18 19-39-27,612,256,356,184,com.yangcong345.android.phone,12121,78.1
2024-01-18 19-39-32,641,269,372,153,com.yangcong345.android.phone,12121,87.5
2024-01-18 19-39-37,491,191,300,303,com.yangcong345.android.phone,12121,78.1
2024-01-18 19-39-42,547,250,297,250,com.yangcong345.android.phone,12121,71.8
2024-01-18 19-39-47,350,143,207,443,com.yangcong345.android.phone,12121,42.8
2024-01-18 19-39-52,436,182,254,339,com.yangcong345.android.phone,12121,39.2
2024-01-18 19-39-57,371,157,214,421,com.yangcong345.android.phone,12121,10.7
2024-01-18 19-40-02,494,216,278,297,com.yangcong345.android.phone,12121,71.8
2024-01-18 19-40-07,340,154,186,450,com.yangcong345.android.phone,12121,21.4
2024-01-18 19-40-12,457,164,293,343,com.yangcong345.android.phone,12121,121
2024-01-18 19-40-17,618,232,386,136,com.yangcong345.android.phone,12121,75.0
2024-01-18 19-40-22,404,163,241,388,com.yangcong345.android.phone,12121,53.1
2024-01-18 19-40-27,396,146,250,396,com.yangcong345.android.phone,12121,10.7
2024-01-18 19-40-32,432,193,239,361,com.yangcong345.android.phone,12121,46.4
2024-01-18 19-40-37,368,150,218,425,com.yangcong345.android.phone,12121,46.4
2024-01-18 19-40-42,378,196,182,386,com.yangcong345.android.phone,12121,50.0
2024-01-18 19-40-47,450,189,261,343,com.yangcong345.android.phone,12121,53.5
2024-01-18 19-40-52,444,219,225,356,com.yangcong345.android.phone,12121,37.5
2024-01-18 19-40-57,389,171,218,407,com.yangcong345.android.phone,12121,46.4
2024-01-18 19-41-02,390,161,229,411,com.yangcong345.android.phone,12121,42.8
2024-01-18 19-41-07,346,157,189,454,com.yangcong345.android.phone,12121,39.2
2024-01-18 19-41-12,443,164,279,346,com.yangcong345.android.phone,12121,3.5
2024-01-18 19-41-17,407,143,264,389,com.yangcong345.android.phone,12121,21.4
2024-01-18 19-41-22,271,100,171,525,com.yangcong345.android.phone,12121,3.5
2024-01-18 19-41-27,346,114,232,443,com.yangcong345.android.phone,12121,3.5
2024-01-18 19-41-32,382,171,211,418,com.yangcong345.android.phone,12121,42.8
2024-01-18 19-41-37,579,211,368,157,com.yangcong345.android.phone,12121,121
2024-01-18 19-41-42,389,139,250,407,com.yangcong345.android.phone,12121,71.4
2024-01-18 19-41-47,406,175,231,391,com.yangcong345.android.phone,12121,46.8
2024-01-18 19-41-52,490,214,276,190,com.yangcong345.android.phone,12121,17.2
2024-01-18 19-41-57,418,150,268,382,com.yangcong345.android.phone,12121,14.2
2024-01-18 19-42-02,404,150,254,389,com.yangcong345.android.phone,12121,39.2
2024-01-18 19-42-07,368,143,225,429,com.yangcong345.android.phone,12121,42.8
2024-01-18 19-42-12,386,136,250,411,com.yangcong345.android.phone,12121,17.8
2024-01-18 19-42-17,572,284,288,178,com.yangcong345.android.phone,12121,112
2024-01-18 19-42-22,393,169,224,403,com.yangcong345.android.phone,12121,41.3
2024-01-18 19-42-27,411,193,218,389,com.yangcong345.android.phone,12121,42.8
2024-01-18 19-42-32,422,186,236,375,com.yangcong345.android.phone,12121,50.0
2024-01-18 19-42-37,375,143,232,418,com.yangcong345.android.phone,12121,14.2
2024-01-18 19-42-42,410,146,264,382,com.yangcong345.android.phone,12121,42.8
2024-01-18 19-42-47,378,146,232,421,com.yangcong345.android.phone,12121,39.2
2024-01-18 19-42-53,341,138,203,456,com.yangcong345.android.phone,12121,46.8
2024-01-18 19-42-57,375,139,236,421,com.yangcong345.android.phone,12121,121
2024-01-18 19-43-02,350,139,211,446,com.yangcong345.android.phone,12121,3.5
2024-01-18 19-43-07,378,146,232,421,com.yangcong345.android.phone,12121,32.1
2024-01-18 19-43-12,369,159,210,428,com.yangcong345.android.phone,12121,44.8
2024-01-18 19-43-17,385,139,246,414,com.yangcong345.android.phone,12121,46.4
2024-01-18 19-43-22,397,161,236,400,com.yangcong345.android.phone,12121,42.8
2024-01-18 19-43-27,343,136,207,446,com.yangcong345.android.phone,12121,3.5
2024-01-18 19-43-32,435,145,290,366,com.yangcong345.android.phone,12121,44.8
2024-01-18 19-43-37,386,141,245,410,com.yangcong345.android.phone,12121,41.3
2024-01-18 19-43-42,393,168,225,404,com.yangcong345.android.phone,12121,46.4
2024-01-18 19-43-47,464,182,282,296,com.yangcong345.android.phone,12121,42.8
2024-01-18 19-43-52,450,168,282,346,com.yangcong345.android.phone,12121,42.8
2024-01-18 19-43-57,354,135,219,445,com.yangcong345.android.phone,12121,32.2
2024-01-18 19-44-02,343,125,218,457,com.yangcong345.android.phone,12121,14.2
2024-01-18 19-44-08,321,132,189,471,com.yangcong345.android.phone,12121,3.5
2024-01-18 19-44-13,293,123,170,503,com.yangcong345.android.phone,12121,3.3
2024-01-18 19-44-17,487,166,321,252,com.yangcong345.android.phone,12121,155
2024-01-18 19-44-22,443,179,264,354,com.yangcong345.android.phone,12121,82.1
2024-01-18 19-44-27,400,150,250,389,com.yangcong345.android.phone,12121,42.8
2024-01-18 19-44-32,415,161,254,375,com.yangcong345.android.phone,12121,39.2
2024-01-18 19-44-37,483,179,304,311,com.yangcong345.android.phone,12121,42.8
2024-01-18 19-44-43,553,244,309,241,com.yangcong345.android.phone,12121,78.1
2024-01-18 19-44-47,389,146,243,407,com.yangcong345.android.phone,12121,46.4
2024-01-18 19-44-52,321,132,189,475,com.yangcong345.android.phone,12121,7.1
2024-01-18 19-44-58,447,161,286,346,com.yangcong345.android.phone,12121,39.2
2024-01-18 19-45-03,347,129,218,446,com.yangcong345.android.phone,12121,3.5
2024-01-18 19-45-08,432,186,246,364,com.yangcong345.android.phone,12121,42.8
2024-01-18 19-45-13,389,168,221,407,com.yangcong345.android.phone,12121,42.8
2024-01-18 19-45-18,400,179,221,248,com.yangcong345.android.phone,12121,3.4
2024-01-18 19-45-23,400,139,261,396,com.yangcong345.android.phone,12121,42.8
2024-01-18 19-45-28,415,204,211,379,com.yangcong345.android.phone,12121,42.8
2024-01-18 19-45-33,429,161,268,364,com.yangcong345.android.phone,12121,25.0
2024-01-18 19-45-38,427,179,248,372,com.yangcong345.android.phone,12121,86.2
2024-01-18 19-45-43,568,250,318,229,com.yangcong345.android.phone,12121,117
2024-01-18 19-45-48,336,129,207,464,com.yangcong345.android.phone,12121,14.2
2024-01-18 19-45-53,461,168,293,304,com.yangcong345.android.phone,12121,42.8
2024-01-18 19-45-58,386,143,243,407,com.yangcong345.android.phone,12121,46.4
2024-01-18 19-46-03,385,146,239,414,com.yangcong345.android.phone,12121,3.5
2024-01-18 19-46-08,392,171,221,407,com.yangcong345.android.phone,12121,32.1
2024-01-18 19-46-13,428,182,246,368,com.yangcong345.android.phone,12121,42.8
2024-01-18 19-46-18,372,129,243,425,com.yangcong345.android.phone,12121,39.2
2024-01-18 19-46-23,367,150,217,430,com.yangcong345.android.phone,12121,30.0
2024-01-18 19-46-28,482,193,289,307,com.yangcong345.android.phone,12121,35.7
2024-01-18 19-46-33,400,150,250,371,com.yangcong345.android.phone,12121,42.8
2024-01-18 19-46-38,407,183,224,355,com.yangcong345.android.phone,12121,37.9
2024-01-18 19-46-43,306,103,203,490,com.yangcong345.android.phone,12121,22.5
2024-01-18 19-46-48,386,176,210,407,com.yangcong345.android.phone,12121,41.3
2024-01-18 19-46-53,497,229,268,300,com.yangcong345.android.phone,12121,35.7
2024-01-18 19-46-58,397,129,268,396,com.yangcong345.android.phone,12121,85.7
2024-01-18 19-47-03,432,164,268,361,com.yangcong345.android.phone,12121,60.7
2024-01-18 19-47-08,622,256,366,166,com.yangcong345.android.phone,12121,75.0
2024-01-18 19-47-13,510,216,294,284,com.yangcong345.android.phone,12121,68.7
2024-01-18 19-47-18,535,163,372,250,com.yangcong345.android.phone,12121,37.5
2024-01-18 19-47-23,341,100,241,413,com.yangcong345.android.phone,12121,37.5
2024-01-18 19-47-28,322,143,179,464,com.yangcong345.android.phone,12121,3.5
2024-01-18 19-47-33,472,179,293,329,com.yangcong345.android.phone,12121,46.4
2024-01-18 19-47-38,360,143,217,433,com.yangcong345.android.phone,12121,43.3
2024-01-18 19-47-43,411,136,275,382,com.yangcong345.android.phone,12121,46.4
2024-01-18 19-47-48,439,168,271,336,com.yangcong345.android.phone,12121,50.0
2024-01-18 19-47-53,497,200,297,293,com.yangcong345.android.phone,12121,65.5
2024-01-18 19-47-58,539,282,257,250,com.yangcong345.android.phone,12121,75.0
2024-01-18 19-48-03,325,128,197,472,com.yangcong345.android.phone,12121,6.8
2024-01-18 19-48-08,468,186,282,318,com.yangcong345.android.phone,12121,85.7
2024-01-18 19-48-13,582,325,257,182,com.yangcong345.android.phone,12121,100
2024-01-18 19-48-18,404,145,259,393,com.yangcong345.android.phone,12121,48.2
2024-01-18 19-48-23,557,218,339,232,com.yangcong345.android.phone,12121,146
2024-01-18 19-48-28,432,175,257,364,com.yangcong345.android.phone,12121,57.1
2024-01-18 19-48-33,397,186,211,400,com.yangcong345.android.phone,12121,42.8
2024-01-18 19-48-38,410,172,238,390,com.yangcong345.android.phone,12121,34.4
2024-01-18 19-48-43,579,241,338,214,com.yangcong345.android.phone,12121,44.8
2024-01-18 19-48-48,390,169,221,403,com.yangcong345.android.phone,12121,51.7
2024-01-18 19-48-53,407,161,246,386,com.yangcong345.android.phone,12121,53.5
2024-01-18 19-48-58,484,231,253,309,com.yangcong345.android.phone,12121,78.1
2024-01-18 19-49-03,480,228,252,314,com.yangcong345.android.phone,12121,65.5
2024-01-18 19-49-08,921,489,432,136,com.yangcong345.android.phone,12121,203
2024-01-18 19-49-13,625,339,286,146,com.yangcong345.android.phone,12121,160
2024-01-18 19-49-18,379,175,204,407,com.yangcong345.android.phone,12121,57.1
2024-01-18 19-49-23,465,236,229,307,com.yangcong345.android.phone,12121,82.1
2024-01-18 19-49-28,293,130,163,503,com.yangcong345.android.phone,12121,50.0
2024-01-18 19-49-33,538,286,252,234,com.yangcong345.android.phone,12121,179
2024-01-18 19-49-38,569,279,290,224,com.yangcong345.android.phone,12121,75.8
2024-01-18 19-49-43,500,243,257,293,com.yangcong345.android.phone,12121,67.8
2024-01-18 19-49-48,421,200,221,371,com.yangcong345.android.phone,12121,53.5
2024-01-18 19-49-53,464,196,268,332,com.yangcong345.android.phone,12121,64.2
2024-01-18 19-49-58,461,207,254,336,com.yangcong345.android.phone,12121,57.1
2024-01-18 19-50-03,450,225,225,346,com.yangcong345.android.phone,12121,57.1
2024-01-18 19-50-08,454,218,236,343,com.yangcong345.android.phone,12121,67.8
2024-01-18 19-50-13,482,214,268,314,com.yangcong345.android.phone,12121,67.8
2024-01-18 19-50-18,471,225,246,329,com.yangcong345.android.phone,12121,57.1
2024-01-18 19-50-23,590,283,307,203,com.yangcong345.android.phone,12121,93.1
2024-01-18 19-50-28,661,357,304,100,com.yangcong345.android.phone,12121,128
2024-01-18 19-50-33,586,250,336,182,com.yangcong345.android.phone,12121,60.7
2024-01-18 19-50-38,691,325,366,91,com.yangcong345.android.phone,12121,184
2024-01-18 19-50-43,461,204,257,332,com.yangcong345.android.phone,12121,60.7
2024-01-18 19-50-48,425,225,200,371,com.yangcong345.android.phone,12121,57.1
2024-01-18 19-50-53,484,242,242,312,com.yangcong345.android.phone,12121,60.6
2024-01-18 19-50-58,521,239,282,246,com.yangcong345.android.phone,12121,53.5
2024-01-18 19-51-03,579,255,324,214,com.yangcong345.android.phone,12121,58.6
2024-01-18 19-51-08,591,278,313,203,com.yangcong345.android.phone,12121,75.0
2024-01-18 19-51-13,533,254,279,257,com.yangcong345.android.phone,12121,57.1
2024-01-18 19-51-18,641,278,363,156,com.yangcong345.android.phone,12121,81.2
2024-01-18 19-51-23,563,275,288,234,com.yangcong345.android.phone,12121,84.3
2024-01-18 19-51-28,535,290,245,255,com.yangcong345.android.phone,12121,100
2024-01-18 19-51-33,478,221,257,318,com.yangcong345.android.phone,12121,53.5
2024-01-18 19-51-38,472,211,261,325,com.yangcong345.android.phone,12121,64.2
2024-01-18 19-51-43,564,247,317,227,com.yangcong345.android.phone,12121,106
2024-01-18 19-51-48,558,248,310,206,com.yangcong345.android.phone,12121,151
2024-01-18 19-51-53,461,229,232,336,com.yangcong345.android.phone,12121,53.5
2024-01-18 19-51-58,462,209,253,334,com.yangcong345.android.phone,12121,56.2
2024-01-18 19-52-03,512,256,256,278,com.yangcong345.android.phone,12121,81.2
2024-01-18 19-52-08,436,207,229,361,com.yangcong345.android.phone,12121,53.5
2024-01-18 19-52-13,541,247,294,253,com.yangcong345.android.phone,12121,78.1
2024-01-18 19-52-18,468,211,257,329,com.yangcong345.android.phone,12121,53.5
2024-01-18 19-52-23,559,275,284,238,com.yangcong345.android.phone,12121,90.6
2024-01-18 19-52-28,382,189,193,418,com.yangcong345.android.phone,12121,53.5
2024-01-18 19-52-33,471,207,264,325,com.yangcong345.android.phone,12121,57.1
2024-01-18 19-52-38,964,514,450,261,com.yangcong345.android.phone,12121,139
2024-01-18 19-52-43,493,218,275,300,com.yangcong345.android.phone,12121,67.8
2024-01-18 19-52-48,557,257,300,239,com.yangcong345.android.phone,12121,60.7
2024-01-18 19-52-53,503,248,255,293,com.yangcong345.android.phone,12121,51.7
2024-01-18 19-52-58,547,236,311,250,com.yangcong345.android.phone,12121,157
2024-01-18 19-53-03,441,207,234,359,com.yangcong345.android.phone,12121,58.6
2024-01-18 19-53-08,438,188,250,356,com.yangcong345.android.phone,12121,50.0
2024-01-18 19-53-13,354,136,218,332,com.yangcong345.android.phone,12121,3.5
2024-01-18 19-53-18,920,490,430,270,com.yangcong345.android.phone,12121,126
2024-01-18 19-53-23,414,175,239,382,com.yangcong345.android.phone,12121,82.1
2024-01-18 19-53-28,489,225,264,304,com.yangcong345.android.phone,12121,53.5
2024-01-18 19-53-33,518,218,300,243,com.yangcong345.android.phone,12121,60.7
2024-01-18 19-53-38,443,207,236,354,com.yangcong345.android.phone,12121,50.0
2024-01-18 19-53-43,450,236,214,346,com.yangcong345.android.phone,12121,64.2
2024-01-18 19-53-48,591,303,288,91,com.yangcong345.android.phone,12121,70.5
2024-01-18 19-53-53,473,197,276,262,com.yangcong345.android.phone,12121,58.6
2024-01-18 19-53-58,464,214,250,332,com.yangcong345.android.phone,12121,57.1
2024-01-18 19-54-03,445,217,228,345,com.yangcong345.android.phone,12121,68.9
2024-01-18 19-54-08,562,310,252,97,com.yangcong345.android.phone,12121,89.6
2024-01-18 19-54-13,572,268,304,225,com.yangcong345.android.phone,12121,121
2024-01-18 19-54-18,443,229,214,354,com.yangcong345.android.phone,12121,57.1
2024-01-18 19-54-23,462,238,224,303,com.yangcong345.android.phone,12121,65.5
2024-01-18 19-54-28,594,300,294,200,com.yangcong345.android.phone,12121,87.5
2024-01-18 19-54-33,473,221,252,314,com.yangcong345.android.phone,12121,68.9
2024-01-18 19-54-38,424,176,248,355,com.yangcong345.android.phone,12121,55.1
2024-01-18 19-54-43,455,210,245,338,com.yangcong345.android.phone,12121,68.9
2024-01-18 19-54-48,547,244,303,197,com.yangcong345.android.phone,12121,68.7
2024-01-18 19-54-53,428,207,221,368,com.yangcong345.android.phone,12121,53.5
2024-01-18 19-54-58,404,194,210,394,com.yangcong345.android.phone,12121,48.3
2024-01-18 19-55-03,489,203,286,297,com.yangcong345.android.phone,12121,51.7
2024-01-18 19-55-08,529,263,266,269,com.yangcong345.android.phone,12121,100
2024-01-18 19-55-13,517,214,303,255,com.yangcong345.android.phone,12121,68.9
2024-01-18 19-55-18,721,421,300,7,com.yangcong345.android.phone,12121,178
2024-01-18 19-55-23,718,339,379,46,com.yangcong345.android.phone,12121,228
2024-01-18 19-55-28,572,243,329,225,com.yangcong345.android.phone,12121,107
2024-01-18 19-55-33,472,241,231,322,com.yangcong345.android.phone,12121,56.2
2024-01-18 19-55-38,717,362,355,72,com.yangcong345.android.phone,12121,65.5
2024-01-18 19-55-43,630,297,333,33,com.yangcong345.android.phone,12121,90.0
2024-01-18 19-55-48,529,243,286,264,com.yangcong345.android.phone,12121,67.8
2024-01-18 19-55-53,542,214,328,248,com.yangcong345.android.phone,12121,65.5
2024-01-18 19-55-58,472,211,261,325,com.yangcong345.android.phone,12121,64.2
2024-01-18 19-56-03,427,193,234,369,com.yangcong345.android.phone,12121,58.6
2024-01-18 19-56-08,546,250,296,218,com.yangcong345.android.phone,12121,50.0
2024-01-18 19-56-13,525,232,293,243,com.yangcong345.android.phone,12121,67.8
2024-01-18 19-56-18,536,211,325,254,com.yangcong345.android.phone,12121,57.1
2024-01-18 19-56-23,471,207,264,325,com.yangcong345.android.phone,12121,67.8
